#P...#.........#######.....###.......#.......#########...###
####.#.#.#####.#.....#####.#.#.#####.#.#####.#.........#....
.....#.#.#.....#.###.#.....#...#...#.#.#.....#.#.#####.####.
.#####.#.#.#####.#.#.#.#.###.###.###.#.#######.###...#.#..#.
.#...#.#.#...#.#.#.#.#.#.#.....#...#.#...........#.#...#....
.#.#...#######.#...#...#...###.###.###.####.####.#######.###
.#.#####.......#####.#######.###.......#.......#.......#...#
.#.....#.#######.............#...#############.###.#######.#
.#####.#.#.......###########.#.#.#...........###.#.#.....#.#
.........#.#.#####.#.........#.#.#.#########.#...#.#.###.#.#
########.#.#.#.#...#.#####.###.#.#.#^^^^^^^#.#.###.#.#...#.#
#..#.......#.#.#.#.......#.#...#.#.#^^^^^^^#.#.....#.#####.#
#.##.#######.#...#.#####.#.#.###.#.#^^^^^^^#.#####.#.......#
#....#...#.#.#####.....#.#.#.#...#.#^^^^^^^#.#...#.#########
####.#.#.#.#.#.....#.#.#.#...#####.#^^^^^^^#.#.#.#.#.#.#....
.......#...#.#######.#########.....#S#######.#.#.#...#.#.##.
.###########...#...#.....#.....#####.........#.#.#####...#..
.#.......#.#.#.#.#.#.###...###.#...###########.#.#.....#.#.#
.#.#####.#...#.#.#.#...#####.#.#.#.............#.####.####.#
...#.....#####...#####.......#...###############......#....#
